------------------
------------------
7------------7----
7----------------7
----7--------7----
7---s------------g